vertiport_id,x,y,z,takeoff_capacity,land_capacity,total_capacity
1,69450,60145.4642928293,0,6,6,12
2,34725,60145.4642928293,0,6,6,12
3,104175,60145.4642928293,0,3,3,6
4,52087.5,30072.7321464146,0,10,10,20
5,52087.5,90218.1964392439,0,2,2,4
6,86812.5,30072.7321464146,0,3,3,6
7,86812.5,90218.1964392439,0,2,2,4
8,0,60145.4642928293,0,6,6,12
9,138900,60145.4642928293,0,3,3,6
10,34725,0,0,9,9,18
11,34725,120290.928585659,0,7,7,14
12,104175,0,0,4,4,8
13,104175,120290.928585659,0,6,4,10
